10 10
s......#..
.####.#.##
#.....#...
..#######.
.....#.#..
#.#......#
.#...#..#.
#..####.#.
##..###...
.##.#...#e
